WOOOIOOOOOOOOOOOOOOW
|OOOOOOOOOOOOOOOOOO|
|OOOOOOOOOOOOOOOOOO|
|OOOOOOL----OOOOOOO|
|OOOOOOOOOOOOO9OOOO|
|OOBBOOOOOOOOOBBOOO|
|OL----OOOOOOL----O|
|OO9OOOOOOOOCOOOOOO|
|OOOOOOOOOOOOOOOOOO|
|OOOOOOL----OOOOOOO|
|OOCOOOOOOOOOAOOOOO|
|OOOOOOOOOOOOOOOOOO|
|OL----OOOOOOL----O|
|OOOOOOOOOOOOOOOOOO|
|OOOOOM--OOOM--OOOO|
|OOOOOOOOOOOOOOO+OO|
|OOS-OOOOOOOOOOOS-O|
|OOOOOOOOOOOOOOOOOO|
|HOOOOOOOOOOOOOOOOO|
F------------------|