WOOOOOOOOOOOOOOOOOOW
|OOOOOOOOOOOOOOOOOO|
|OOOOOOOOOOIOOOOOOO|
|OOOOOOOOOIOOOOO+OO|
|OOOOOOOOOOOOOOOOOO|
S-OOOM--M--S-S-OOOS-
|O+OOOOOOO9OOOOIOOO|
|OOOOOOOOOOOOOOOOOO|
S-OOOM--M--S-S-OOOS-
|OOOOOOOOOOOOOOOOOO|
|OIOOOOOOOOOOOIOOOO|
|OOOOAOOOOOCOOOOOOO|
|OOOOOOOOOOOOOOOOOO|
|OOOOOOM--OOOOOCOOO|
|OOOOOOOOOOOOOBOOOO|
|OOOOOOOOOOOOOOOOOO|
S-OOOM--M--S-S-OOOS-
|OOOOOOOOOOOOOOOOOO|
|HOOOOOOOOOOOOOOOOO|
F------------------|