WOOOOOOOOOOOOOOOOOOW
|OOOOOOOOOOOOOOOOOO|
|IOOOOOOOOOOOOOOOOI|
F------------------|
|O+OOOOOOOOOOOBOOOO|
|OOOOOOOOOOOL----S-|
|OOOOOOO9OOS-OOOOOO|
|OOOOOOOOOS-OOOOOOO|
|OOOCOOOOS-OOOOOOOO|
|OOOOOOOS-OOOOOOOOO|
|OOOOOOS-OOOOOOOOOO|
|OAOOOS-OOOOOOOOOOO|
|OOOOS-OOOOOOOOOOOO|
|OOOS-O0OOOOOOOOOOO|
|OOS-OOOOOOOOOOOOOO|
|OS-OOOOOOOOOOOOOOO|
|S-OOOOOCOOOOOOOOOO|
S-OOOOOOOOOOOOO9OOO|
|HOOOOOOOOOOOOOOOOO|
F------------------|