WOOOOOOOOOOOOOOOOOOW
|OOOOOOOOOOOOOOOOOO|
|OOOOIBIBBIB0B0OOOO|
|OOOOL----L----OOOO|
|OOOOOOOOOOOOOOOOOO|
|OOOOOOOOOOOOO+OOOO|
|OOOOOOOOOOOOOOOOOO|
|OOOOOOOOOOOOOOOOOO|
|OOOOOOOOOIOOOCOOOO|
|S--OO0OOOOOOOOOS-S|
|OOO9OOOOCOOOOOOOOO|
|OOOIOOOOOOOOAOOOOO|
|OOOOOOOS--OOOOOOOO|
|OOOOOOOOOOOOOOOOOO|
|OOOOOOOOOOOOOOO9OO|
|OOOM--OOOOOM--OOOO|
|OOOOOOL----OOOOOOO|
|OOOOCOOOOOOOOOOOOO|
|HOOOOOOOOOOOOOOOOO|
F------------------|
