WOOOOOOOOOOOOOOOOOOW
|OOOOOOOOOOOOOOOOOO|
|OOOOOOOOOOOOOOOOOO|
|OOOCOOOOOOOOOO9OOO|
|OOOOOS-M--S-OOOOOO|
|OOOOOOOOO+OOOOCOOO|
|OBOO9OOOCOOOOOOOBO|
S-OOOM--M--S-S-OOOS-
|OOOOOOOOOOOOOOOOOO|
|OOOCOOOOOOOOOO0OOO|
S-OOO000M--0000OOOS-
|OOO9OOOOOOOIOOOOOO|
|OOOOOOOOOOOOOCOOOO|
S-OOOM--M--S-S-OOOS-
|0OOOOIOOOO0OOOOAOO|
|OOOOOOOOOO0O9OOOOO|
S-OOOM--M--S-S-OOOS-
|OOOOOCOOOOOOOOOOOO|
|HOOOOOOOOOOOOOOOOO|
F------------------|
