WOOOOOOOOOOOOOOOOOOW
|OOOOOOOOOOOOOOOOOO|
|OOOOOOOOOOOOOOOOOO|
|OOO7OOOOOOOOOO7OOO|
|OOO7OOOOO+OOOB7OO7|
|OOOS-OOOOCOOOS-OOO|
|OOO7OOOOOOOOOO7OOO|
|OOO7OOOS-S-OOO7OO7|
|OOO7OOOOOOOOOO7OOO|
|OOO7HOOOOOOOOO7OOO|
|OOO7L----L----7OO7|
|OOOOOOOOOOOOOOOOOO|
|S--OOAOOOOOOOOO9OO|
|OOOOOOOOOOOCOOOOO7|
|OOOOOIOOOIOOOIOOOO|
|OOO7L----L----7OOO|
|OOOOOOCOOIOOOOOOOO|
|OOOOOOOL----OOOOOO|
|OOOOOOOOOOOO9OOOOO|
F------------------|
