WOOOOOOOOOOOOOOOOOOW
|OOBOOOOOOOOOOOOBOO|
|L----OOOOOOOOL----|
|OOOOOOOOM--OOOOOOO|
|OOOOOOOOOOOOOOOOOO|
|OOOOOOOOM--OOOOOOO|
|OOCOOOOBOOOBOOOOOO|
|OOOOL----L----OOOO|
|OOOOOOOOOOOOOOOOOO|
|0OAOOOOO+OOOOOOOOO|
|L----OOOOOOOOL----|
|OOOO7OOOOOOOO7OOOO|
|OOOO7OOOOOOOO7OOOO|
|OOOOS-OOOCOOO7OOOO|
|COOO7OOOOOOOO7OOOO|
|OOOO7O9OOOOOO7OOOO|
|OOOOS-OOOOOOO7OOOO|
|OOOO7OOOOOOOO7OOOO|
|HOOOOOOOOOOOOOOOOO|
F------------------|
