WOOOOOOOOOOOOOOOOOOW
|OOOOOOOOOOOO+OOOOO|
|OOOOOBOOOOOOOOBOOO|
|OOOM--OOOOOOM--OOO|
|OOL----OOOOL----OO|
|OOOM--OOOOOOM--OOO|
|OOO9OOOOBOOOOOOOOO|
|OOOOOOOOS-OOOOOCOO|
|OOOOO9OOOOOOO9OOOO|
|OOOBOOOOOOAOOOOBOO|
|OOOL----OOOOL----O|
|OOCOOOOOOOOOOOOOOO|
|OOOOOOOOOBOOOOOO9O|
|OOOOOOOOS-OOOOOCOO|
|OO9OOOOOOOOOOOOOOO|
|OOOOM--OOOOOOM--OO|
|OOOL----OOOOL----O|
|OCOOM--OOOOOOM--OO|
|HOOOOOOOOOOOOOOOOO|
F------------------|