WOOOOOOOOOOOOOOOOOOW
|OOOOOOOOOOOOOOOOOO|
|M--OOOOOOOOOOOOM--|
|OOOOOOOOOOBOOOOOOO|
|OOOOOOL----OOOOOOO|
|M--OOOIOOOOOOOOM--|
|OOOCOOOOOO+OOOOOOO|
|OOOOOOL----OOOOCOO|
|M--OOOOOOOOOOOOM--|
|OOOOOOOBOOOOOOCOOO|
|OOOOOOL----OOOOOOO|
|M--OOOOOOOOOOOOM--|
|OOOOIOOOIOOOOOOOOO|
|OOOOOOL----OOOOOOO|
|M--OOOOOOOOOOOOM--|
|OOOOAOOOBOOOOOOOOO|
|OCOOOOL----OOOOOOO|
|OOOOOOOOOOOOOOOOOO|
|HOOOOOOOOOOOOOOOOO|
F------------------|